111111111111111111111111111111130011111111112011111111110011111400000011111000000011111111101011111111132011111111111111111111111111111111111111
111111111111111111111111111001000111110001300011110401110011110001110011110002010011110000000011110000100011111000100111111111111111111111111111
111111111111111111111111111113111111111110111111111110111111111112020311113002411111111111211111111111011111111111311111111111111111111111111111
111111111111111111111111111100011111111100010011111110000311111110111311111020111311111022111111111400111111111111111111111111111111111111111111
111111111111111110330111111110000111111111411111111111211111111111011111111111011111111000011111111012001111111000101111111110001111111111111111
111111111111111111111111111111111111111111111111114000100001110222220201110000300001111111311111111110311111111110333111111111111111111111111111
111111111111111111111111111111111111111140011111111132501111111100101111111100001111111111111111111111111111111111111111111111111111111111111111
111111111111111111111111110001111111112001111111110021111111002020111111010110111111010110110033002000000003110101410033110001111111111111111111
111111111111111111111111111001111111111000001111111000001111111110111111111022001111111030340111111111000111111111111111111111111111111111111111
111111111111111111111111330010000011330010200200330012111100330000401100330010100201111110112020110200202020110000100000111111111111111111111111
111111111111111111111111111101111111111001110011110200000011100042010011111021110011111001330011111011310111110000001111110000011111111111111111
111111111111131310000041133310212011133310200211133311202011100110201011100110200200100002002000100111111111100111111111111111111111111111111111
111111111111111111111111111111111111111001001111110055231111110001000111111104000111111111100111111111111111111111111111111111111111111111111111
111111111111330001111411330001110001330000002201330001010201330111010201111102012001111100210201111102002001111100110001111111111111111111111111
111111111111111111111111111111111111111111111111111103111111111100111111111154001111111100201111111100111111111111111111111111111111111111111111
111111111111111111111111111111110011111111112311111000202311111024233311111022233111111002033111111111111111111111111111111111111111111111111111
111111111111111111110001110104110220100002000000100200111000111011111211102001110331102020203331100001113331102201113331100111111111111111111111
111111111111111111104111100000200111100021102111112133310111110233300111110130310111110001012011112002000011110011111111111111111111111111111111
111111111111111111111111111111100011111111031001111110004001111100501001111002011111111050111111111001111111111111111111111111111111111111111111
111111111111111111111111111111001111111110001111111100520111111101014111111100530111111111001111111111001111111111111111111111111111111111111111
111111111111111111111111111111111111111100111111111153400111111103210111111112000111111110001111111111111111111111111111111111111111111111111111
111111111111111111111111111111111111111000100111111010123111111000023111111010123111111000100111111111140111111111111111111111111111111111111111
111111111111111111111111111111111111111111001111111110301111111142220111111130310111111101000111111100011111111111111111111111111111111111111111
111111111111111111111111111111111111111100011111110223301111110304101111111010001111111052011111111110011111111111111111111111111111111111111111
111111111111111111111111111104011111111100011111111322231111100233320011100231320011100233320011111322231111111100011111111100011111111111111111
000000000000000000000000000030030000000000000000001000000100000111111000000000000400011100011100010000010000010110010110010010010010011110011110